1111111111
1CPE0000C1
1000000001
1C000000C1
1111111111