1111111111
1CPECCCCC1
1000000001
1CCCCCC0C1
1111111111