1111111111
1CPECCCCC1
1000000001
1CCCCCCCC1
1111111111