1111111111
1CPE0000C1
1000000001
1CCC0CCCC1
1111111111