11111111111111111111111
1E00000C000000C000001
101001010010000101001
101010100100100001
10000C000C000000C01
11K111111111101111111