111111111111111111111111111111
100000000000000000E00000000001
1000000000100000001000000000C1
100000111000000000001000000011
100000000000000000000000000001
101000000000000000000000010001
100000000000000000000000000001
100000C00000000000001000000001
100000111000000000000000000001
10000000000001110000000000C001
100000000000000000000000000001
10000000000000C000001111000001
100011100000000000000000000001
10P000000000000000000000000001
111111111111111111111111111111