111111111111111111111
1PE0000C000000C000001
100000000010000000001
100000111000010000001
101000000000000000001
111111111111111111111