111111111111111111111
1E00000C000000C000001
101001010010000101001
101E01001001000100001
1P0000C000C0000000C01
111111111111111111111