111111111111111111111
1P0000000000000000E01
1000000C0010000110101
100000111000011100001
1P1000000000000000001
100000000000001100001
111111111111111111111