11111111111111111111111
1E00000C000000C000001
101001010010000101001
101E01001001000100001
100000C000C0000000C01
11K111111111101111111